R 940 720
NO ./path_to_the_north_texture
SO ./path_to_the_south_texture
WE ./path_to_the_west_texture
EA ./path_to_the_east_texture
S ./texture/wood.xpm
F 250,100,0
C 225,30,0

111111111111111
100000001000001
100000001000001
100000000000001
10000S000000001
100000000000001
111111100000001
100000100000001
100000000000001
111111111111111
