R 940 720
NO ./textures/eagle.xpm
EA ./textures/red.xpm
S ./textures/tonneau.xpm
SO ./textures/greystone.xpm
F 100,140,120
C 135,200,235
WE ./textures/purplestone.xpm

        1111111111111111111111111
        1000000000000000000000001
        1001002200200200002000021
        1001000000000000000000001
111111111011000000000000000000W01
100000000011000001110111110111111
11110111111111011100000010001
11110111111111011100000010001
11000000110101011100000010001
10000000000000001100000010001
10000000000000001101010010001
1100000110010101111101111000111
1111011111110101 101111010001
 1111111 1111111 111111111111
