R 940 720
NO ./textures/eagle.xpm
SO ./textures/greystone.xpm
EA ./textures/red.xpm
WE ./textures/purplestone.xpm
S ./textures/tonneau.xpm
C 135,200,235
F 255,140,120

        1111111111111111111111111
        1000000000000000000000001
        1001002200200200002000021
        1001000000000000000000001
111111111011000000000000000000001
100000000011000001110111110111111
11110111111111011100000010001
11110111111111011100000010001
11000000110101011100000010001
10000000000000001100000010001
10000000000000001101010010001
11000001100101011111011110N0111
1111011111110101 101111010001
 1111111 1111111 1111111111111