R 500 500
NO ./textures/eagle.xpm
SO ./textures/greystone.xpm
WE ./textures/purplestone.xpm
EA ./textures/red.xpm
S ./textures/tonneau.xpm
F 100,100,100
C 135,206,235

        1111111111111111111111111
        1000000000110000000000001
        1011000001110000002000001
        1001000000000000000000001
111111111011000001110000000000001
100000000011000001110111110111111
11110111111111011100000010001
11110111111111011100000010001
110000001101010111000N0010001
10002000000000001100000010001
10000000000000001101010010001
1100000111010101111101111000111
11112111 1110101 101111010001
 1111111 1111111 111111111111
